NO ./copy1.xpm
SO ./copy2.xpm
WE ./copy3.xpm
EA ./copy4.xpm

F 220,100,0
C 0,255,255

111111111
10N100011
101001001
100001011
111111111