NO images/cartoone.xpm
SO images/bob.xpm
WE images/cartoone.xpm
EA images/bob.xpm

F 204,102,0
C 0,255,255

11111
10001
10N01
11111