NO images/Dungeon_1.xpm
SO images/Dungeon_2.xpm
WE images/Dungeon_3.xpm
EA images/Dungeon_4.xpm

F 44, 62, 80
C 97, 106, 107

11111
10001
10N01
11111