NO ./copy1.xpm
SO ./copy2.xpm
WE ./copy3.xpm
EA ./copy4.xpm

F 220,100,0
C 0,255,255

111111111
100100011
101001001
10S001011
111111111