NO ./copy1.xpm
SO ./copy2.xpm
WE ./copy3.xpm
EA ./copy4.xpm

F 153,76,0
C 192,192,192

111111111
100000001
1000N0001
100000001
111111111