NO images/cartoone.xpm
SO images/bob.xpm
WE images/cartoone.xpm
EA images/bob.xpm

F 204,102,0
C 0,255,255

111111111
100000001
1000N0001
100000001
111111111