NO images/walls.xpm
WE images/red_wall.xpm
EA images/walls.xpm
SO images/red_wall.xpm

F 51,25,0
C 64,64,64


        1111111111111111111111111
        1000000000110000000000001
        1011000001110000000000001
        1001000000000000000000001
11111111101100000111000000N000001
10000000001100000111011111111111111111111111
11110111111111011100000010001
11110111111111011101010010001
11000000110101011100000010001
10000000000000001100000010001
10000000000000001101010010001
110000011010101111101111000111
11110111 1110101 101111010001
11111111 1111111 111111111111
